1
***********
* $.*******
*.$ *******
* . *******
*   *******
*$# *******
* @ *******
***********
***********
***********
***********


Solution: 
ruuulluuRDrddddllUUU

Complete solution took: 1.527ms.