2
***********
*# . . ****
*# @$$ ****
*  .$  ****
***********
***********
***********
***********
***********
***********
***********


Solution: 
urrrddlULullddrUrrdL

Complete solution took: 0.085ms.