2
*********************
*********************
*********************
*********************
*****########********
*****#  #   #********
*****#    . #********
*****#      #********
*****#    ###********
*****#      #********
*****#  $   #********
*****# @ #  #********
*****########********
*********************
*********************
*********************
*********************
*********************
*********************
*********************