5
********************
********************
********************
********************
********************
******#####*********
******#   #*********
*****##   #*********
*****# $ ##*********
*****# @ .#*********
*****######*********
********************
********************
********************
********************
********************
********************
********************
********************
********************
