1
***********##*******
********************
********************
******####**********
******#  ###********
******#    #********
******#    #********
******### ###*******
******#     #*******
******#  @ .#*******
******#  $  #*******
******###  ##*******
********####********
********************
********************
********************
********************
********************
********************
********************