1
***********
*  .*******
*. $*******
* @ *******
*#$ *******
*#  *******
*###*******
***********
***********
***********
***********


Solution: 
rddlUUrUL

Complete solution took: 1544ms.