1
********************
********************
********************
******####**********
******#  ###********
******#   @#********
******#    #********
******### ###*******
******#     #*******
******#    .#*******
******#  $  #*******
******###  ##*******
********####********
********************
********************
********************
********************
********************
********************
********************