1
***********
*#########*
*  #######*
*  #######*
*#    ####*
*#   $ ###*
*#     ###*
*###   . #*
*    . $##*
*##### @ #*
***********


Solution: 
UluulluurDDD

Complete solution took: 139ms.