10
***********
*.  *******
*@#.*******
*$ $*******
*   *******
*   *******
*   *******
***********
***********
***********
***********


Solution: 
DrdrUddllUUU

Complete solution took: 638ms.