11
***********
* $.*******
*   *******
* $ *******
*# .*******
*   *******
* @#*******
***********
***********
***********
***********


Solution: 
uuUluuRDldRurD

Complete solution took: 85ms.