12
***********
*  #*******
*   *******
*#$ *******
*  .*******
*@ $*******
* . *******
***********
***********
***********
***********


Solution: 
urruulDDlddrrUdlluurD

Complete solution took: 723ms.