13
***********
*   *******
* . *******
*@ #*******
*   *******
* $ *******
* $.*******
***********
***********
***********
***********


Solution: 
dddRUUU

Complete solution took: 951ms.