14
***********
*# .*******
*#@$*******
*#  *******
*   *******
* $.*******
*   *******
***********
***********
***********
***********


Solution: 
drUddlldR

Complete solution took: 480ms.