15
***********
*###*******
* @#*******
* $#*******
*  .*******
*  $*******
* . *******
***********
***********
***********
***********


Solution: 
DDlddrrUdlluurD

Complete solution took: 79ms.