16
***********
*   *******
*.$ *******
* . *******
*  #*******
*$@ *******
*  #*******
***********
***********
***********
***********


Solution: 
dlUUUrruulD

Complete solution took: 493ms.