17
***********
*# #*******
*   *******
* $ *******
*.  *******
*@$.*******
*###*******
***********
***********
***********
***********


Solution: 
RuruLulD

Complete solution took: 236ms.