18
***********
*   *******
* $ *******
*   *******
* .#*******
*$ #*******
*.@#*******
***********
***********
***********
***********


Solution: 
uulDuuuurDD

Complete solution took: 581ms.