19
***********
* ..*******
*  $*******
*   *******
*# #*******
* $ *******
*#@#*******
***********
***********
***********
***********


Solution: 
UUUUdrU

Complete solution took: 572ms.