2
***********
*#  *******
* $ *******
*@ .*******
* $#*******
* . *******
*# #*******
***********
***********
***********
***********


Solution: 
uRurDldD

Complete solution took: 78ms.