20
***********
*# .*******
* $ *******
*  .*******
*# $*******
*# @*******
*#  *******
***********
***********
***********
***********


Solution: 
luuluRdrUdlddrU

Complete solution took: 361ms.