21
***********
*  .*******
* $ *******
*   *******
*#. *******
* $ *******
*@ #*******
***********
***********
***********
***********


Solution: 
rUruulUluR

Complete solution took: 909ms.