22
***********
*# #*******
*  .*******
*  #*******
* @ *******
* $$*******
*  .*******
***********
***********
***********
***********


Solution: 
rDullddrUUUluR

Complete solution took: 168ms.