23
***********
*  .*******
*. $*******
* $ *******
*# #*******
* @ *******
*# #*******
***********
***********
***********
***********


Solution: 
uUrUL

Complete solution took: 323ms.