25
***********
*#  *******
*   *******
*  .*******
*$$#*******
* @ *******
*. #*******
***********
***********
***********
***********


Solution: 
UUlDDuuuRurD

Complete solution took: 1771ms.