26
***********
*###*******
*#  *******
*# #*******
*.$ *******
* #@*******
*.$ *******
***********
***********
***********
***********


Solution: 
uLrddL

Complete solution took: 236ms.