27
***********
*#  *******
* $ *******
*   *******
*# #*******
*@$.*******
* .#*******
***********
***********
***********
***********


Solution: 
RuuruulDDDD

Complete solution took: 637ms.