28
***********
*@ #*******
* $#*******
*  #*******
*$. *******
* # *******
*.  *******
***********
***********
***********
***********


Solution: 
rDDlDD

Complete solution took: 320ms.