29
***********
*@ #*******
* $ *******
*.  *******
*#$ *******
* . *******
*# #*******
***********
***********
***********
***********


Solution: 
rDrdLD

Complete solution took: 631ms.