3
***********
*@  *******
* $$*******
*  .*******
*#  *******
*#. *******
*###*******
***********
***********
***********
***********


Solution: 
rrDulDDD

Complete solution took: 1333ms.