3
********************
********************
********************
********************
*****#####**********
*****#...#**********
******#$ #**********
******#@ ##*********
*****# $$ #*********
*****#   ##*********
*****#  ##**********
*****#####**********
********************
********************
********************
********************
********************
********************
********************
********************