30
***********
*  #*******
*   *******
*$ #*******
* $@*******
*.  *******
*.  *******
***********
***********
***********
***********


Solution: 
dlluUruulDDDurDDrdL

Complete solution took: 172ms.