31
***********
*#  *******
*   *******
* $ *******
*. @*******
*$#.*******
*   *******
***********
***********
***********
***********


Solution: 
ddllUUrruullDRurDD

Complete solution took: 88ms.