32
***********
*  #*******
* $ *******
*  #*******
*@ #*******
*$ #*******
*..#*******
***********
***********
***********
***********


Solution: 
DuuuurDDDD

Complete solution took: 77ms.