33
***********
*#. *******
* $ *******
*  .*******
*#@$*******
*   *******
*#  *******
***********
***********
***********
***********


Solution: 
drUluU

Complete solution took: 158ms.