34
***********
*###*******
*#  *******
*#.@*******
*#$$*******
*   *******
*# .*******
***********
***********
***********
***********


Solution: 
DDlU

Complete solution took: 78ms.