35
***********
*.$ *******
*   *******
*#@#*******
*#$#*******
*   *******
* .#*******
***********
***********
***********
***********


Solution: 
uruLddDD

Complete solution took: 336ms.