36
***********
* .#*******
*   *******
*# $*******
*#$.*******
*#@ *******
*###*******
***********
***********
***********
***********


Solution: 
UUUrD

Complete solution took: 158ms.