37
***********
*   *******
* $ *******
*.@ *******
*  .*******
*$# *******
*   *******
***********
***********
***********
***********


Solution: 
ruulDDrdddllUUR

Complete solution took: 164ms.