38
***********
* . *******
*  $*******
*   *******
*#$.*******
* @ *******
*# #*******
***********
***********
***********
***********


Solution: 
UUluurrDDlU

Complete solution took: 853ms.