39
***********
*#  *******
*#..*******
*#  *******
* $@*******
* $ *******
*   *******
***********
***********
***********
***********


Solution: 
ddlluRUUdddrUUU

Complete solution took: 169ms.