4
********************
********************
********************
******####**********
******#  ###********
******#    #********
******#    #********
******#  $.##*******
******#     #*******
******#  @ .#*******
******#  $  #*******
******###  ##*******
********####********
********************
********************
********************
********************
********************
********************
********************