4
***********
*#  *******
*   *******
* @#*******
*  #*******
*$$.*******
*. #*******
***********
***********
***********
***********


Solution: 
dlDR

Complete solution took: 1468ms.