40
***********
* @#*******
*   *******
*   *******
*$ #*******
* $#*******
*. .*******
***********
***********
***********
***********


Solution: 
dddDldRuuulDD

Complete solution took: 79ms.