41
***********
*  .*******
* $@*******
*#  *******
*#. *******
*#$ *******
*   *******
***********
***********
***********
***********


Solution: 
ulldRdrUddddlU

Complete solution took: 320ms.