42
***********
*.  *******
* $ *******
*$  *******
*   *******
*@. *******
*###*******
***********
***********
***********
***********


Solution: 
uUUdrruulDDD

Complete solution took: 31ms.