43
***********
*   *******
* # *******
*  @*******
*. $*******
*$  *******
*  .*******
***********
***********
***********
***********


Solution: 
DDldlU

Complete solution took: 317ms.