44
***********
*  @*******
*$#$*******
*. .*******
*# #*******
*   *******
*# #*******
***********
***********
***********
***********


Solution: 
DullD

Complete solution took: 163ms.