45
***********
*#  *******
*##.*******
*#@$*******
*#$ *******
* . *******
*# #*******
***********
***********
***********
***********


Solution: 
DrU

Complete solution took: 735ms.