46
***********
* @#*******
* $ *******
* .#*******
*# #*******
* $ *******
* .#*******
***********
***********
***********
***********


Solution: 
lddrdDuuluurD

Complete solution took: 647ms.