47
***********
* @ *******
*$  *******
*  #*******
* $#*******
*  #*******
*..#*******
***********
***********
***********
***********


Solution: 
lDDDDuurDD

Complete solution took: 482ms.