48
***********
*  #*******
*.$ *******
*   *******
*$  *******
* @.*******
* ##*******
***********
***********
***********
***********


Solution: 
uuluurDldRurDDldlUU

Complete solution took: 991ms.