49
***********
*   *******
*. $*******
*   *******
*#$.*******
*#@ *******
*###*******
***********
***********
***********
***********


Solution: 
UUluurrDDuL

Complete solution took: 331ms.