5
***********
* @ *******
* $ *******
*#$.*******
*   *******
* . *******
*   *******
***********
***********
***********
***********


Solution: 
ldRurDlDD

Complete solution took: 1123ms.