50
***********
*.  *******
*$$@*******
* . *******
*# #*******
*#  *******
*###*******
***********
***********
***********
***********


Solution: 
dllUdrruulD

Complete solution took: 247ms.