51
***********
*###*******
*.$ *******
* @.*******
*# $*******
*   *******
*# #*******
***********
***********
***********
***********


Solution: 
ruLdddrU

Complete solution took: 316ms.