52
***********
*# #*******
*.. *******
*  @*******
* $#*******
* $ *******
*   *******
***********
***********
***********
***********


Solution: 
lldddrruLUUdddlUUU

Complete solution took: 85ms.