53
***********
* $.*******
* #.*******
*  $*******
*#  *******
*#  *******
* @ *******
***********
***********
***********
***********


Solution: 
uurUlluuR

Complete solution took: 874ms.