6
***********
* @.*******
* $$*******
*#  *******
*#  *******
* . *******
*# #*******
***********
***********
***********
***********


Solution: 
DDDurU

Complete solution took: 1332ms.