7
***********
*## *******
*##.*******
*##$*******
*  .*******
* @$*******
*#  *******
***********
***********
***********
***********


Solution: 
urUdlddrU

Complete solution took: 410ms.