8
***********
* .#*******
*.@#*******
* $#*******
*$  *******
* # *******
*   *******
***********
***********
***********
***********


Solution: 
ldDrUUddrddllUUU

Complete solution took: 79ms.