9
***********
*.  *******
*$ @*******
*   *******
*. #*******
* $#*******
*   *******
***********
***********
***********
***********


Solution: 
dldlddrUUluUrrdLulD

Complete solution took: 204ms.