Level 2
* * * * * * * * * * * 
*       #     # #   * 
*       .           * 
*                   * 
*       # # #     # * 
*           #       * 
* #         # #     * 
*     # #     # # # * 
*   $   #   $     # * 
*     # # .   @   # * 
* * * * * * * * * * * 
