Level 2
***********
*######   *
*     $   *
* $       *
*###   ###*
*     .  #*
*  .     #*
*   #@ # #*
*   #    #*
*#  ######*
***********


Solution: 
uuuuuRRurDrdLLulDDuullllldRRurDDDrdL

Complete solution took: 2001ms.