Level 1
***********
*#######  *
*######   *
*######  .*
*.  @ #   *
*   $     *
*         *
*###  ## #*
*       $ *
*###  #  #*
***********


Solution: 
rdLLLdlUrrrrdddrrdrUUUUUluR

Complete solution took: 1027ms.