Level 2
* * * * * * * * * * * 
* #         # # # # * 
* #       $ #       * 
* # $       #       * 
*     #           # * 
*       @           * 
*             #   # * 
*     # #     .     * 
*     .         #   * 
* #                 * 
* * * * * * * * * * * 
