Level 3
* * * * * * * * * * * 
* # # #   . # # # # * 
* # # #       # # # * 
* # # #       # # # * 
* # # #       # .   * 
*           @ #     * 
*             # $   * 
* # # #           # * 
* # # #     $     # * 
* # # #           # * 
* * * * * * * * * * * 
