Level 3
* * * * * * * * * * * 
*       .   #       * 
*           $       * 
*             #   # * 
*     # # # #   $ # * 
*       # # #     # * 
*       # # #       * 
*     # #           * 
*       #     @     * 
*           .     # * 
* * * * * * * * * * * 
