Level 3
***********
*   .     *
*        #*
*#    #  #*
*###      *
*   .     *
*     $   *
*###  @#  *
*###$  ## *
*###   #  *
***********


Solution: 
UruLddddllUUUrUUUUruL

Complete solution took: 2254ms.