Level 1
* * * * * * * * * * * 
* # # # # # # # # # * 
* # # # # # # # # # * 
* # # # # # # # # # * 
*     $ @     $   . * 
*         .         * 
*                   * 
* #     #     # #   * 
*       #     # #   * 
*             # #   * 
* * * * * * * * * * * 
