Level 1
* * * * * * * * * * * 
* # # # # # #       * 
*       $           * 
*                   * 
* $   # #     # # # * 
* . @ #       # # # * 
* # # #   .   # # # * 
*       #           * 
*   #             # * 
*                 # * 
* * * * * * * * * * * 
